NO ./game_data/textures/north.jpg
SO ./game_data/textures/east.jpg
WE ./game_data/textures/east.jpg
EA ./game_data/textures/east.jpg

F 0,0,255
C 150,75,0

1111111111
1000000001
1001000001
1000000101
1000N00001
1000000001
1001000001
1000010001
1000000001
1111111111