NO ./game_data/textures/north.jpg
SO ./game_data/textures/east.jpg
WE ./game_data/textures/east.jpg
EA ./game_data/textures/east.jpg

F 0,0,0
C 50,0,30

11111111111111111111111111111
10000000000000000000000000001
10010000000000000000000000001
10000001000000000000000000001
10000000000000000000000000001
10000000000000000000000000001
10010000000000000000000000001
10000100000000000000000000001
10000000000000000000000000001
11111111111111111111100001111
                 100000000001111111111111111111
                 10000000000000000000000000S011
                 111111111111111111111111111111
                 111111111111