NO ./game_data/textures/north.jpg
SO ./game_data/textures/east.jpg
WE ./game_data/textures/east.jpg
EA ./game_data/textures/east.jpg

F 220,100,0
C 225,30,0


11111111111
10001110001
10001 10001
10001110001
11111111111