NO ./game_data/textures/poles_textures/north.xpm
SO ./game_data/textures/poles_textures/south.xpm
WE ./game_data/textures/poles_textures/west.xpm
EA ./game_data/textures/poles_textures/east.xpm

F 255,255,255
C 0,0,25

1111111
1000001
1000001
1000001
1000001
1N00001
1111111