NO ./game_data/textures/north.xpm
SO ./game_data/textures/east.xpm
WE ./game_data/textures/east.xpm
EA ./game_data/textures/east.xpm

F 135,206,235
C 155,118,83


1111111
1000001
1000001
100N001
1000001
1000001
1111111