NO ./game_data/textures/north.xpm
SO ./game_data/textures/east.xpm
WE ./game_data/textures/south.xpm
EA ./game_data/textures/west.xpm

F 135,206,235
C 155,118,83


1111111    1111111111111111111111111111111111
1000001    1000000000000000000000011000000011
1000001    1000000000000000000000000000000011
100N00111111000000000000000000111110000001111
100000000000000000000100010101011111111111111
10000011111111111111111111111111
1111111